import keyboard
#pense à importer ca bouffon

hauteur_map = 30
largeur_map = 30


def create_map(hauteur_map, largeur_map):
    map = []
    for i in range(hauteur_map):
        if i == 0 or i == hauteur_map - 1:
            map.append([1 for k in range(largeur_map)])
        else:
            map.append([])
            map[i].append(1)
            for j in range(1, largeur_map - 1):
                map[i].append(0)
            map[i].append(1)
    return map


def detect_key_press():
    key = ""
    while key == "":
        if keyboard.is_pressed("q"):
            key = "q"
            break
        elif keyboard.is_pressed("z"):
            key = "z"
            break
        elif keyboard.is_pressed("s"):
            key = "s"
            break
        elif keyboard.is_pressed("d"):
            key = "d"
            break
    return key


for ligne in create_map(hauteur_map, largeur_map):
    print(ligne)

# Map en binaire (ne pas effacer)
map1 = [[1, 1, 1, 1, 1, 1, 1, 1, 1, 1, 1, 1, 1, 1, 1, 1, 1, 1, 1],
       [1, 0, 0, 0, 0, 0, 0, 0, 0, 1, 0, 0, 0, 0, 0, 0, 0, 0, 1],
       [1, 0, 1, 1, 0, 1, 1, 1, 0, 1, 0, 1, 1, 1, 0, 1, 1, 0, 1],
       [1, 0, 0, 0, 0, 0, 0, 0, 0, 0, 0, 0, 0, 0, 0, 0, 0, 0, 1],
       [1, 0, 1, 1, 0, 1, 0, 1, 1, 1, 1, 1, 0, 1, 0, 1, 1, 0, 1],
       [1, 0, 0, 0, 0, 1, 0, 0, 0, 1, 0, 0, 0, 1, 0, 0, 0, 0, 1],
       [1, 1, 1, 1, 0, 1, 1, 1, 0, 1, 0, 1, 1, 1, 0, 1, 1, 1, 1],
       [1, 1, 1, 1, 0, 1, 0, 0, 0, 0, 0, 0, 0, 1, 0, 1, 1, 1, 1],
       [0, 0, 0, 0, 0, 0, 0, 1, 1, 1, 1, 1, 0, 0, 0, 0, 0, 0, 0],
       [1, 1, 1, 1, 0, 1, 0, 0, 0, 0, 0, 0, 0, 1, 0, 1, 1, 1, 1],
       [1, 1, 1, 1, 0, 1, 1, 1, 0, 1, 0, 1, 1, 1, 0, 1, 1, 1, 1],
       [1, 0, 0, 0, 0, 1, 0, 0, 0, 1, 0, 0, 0, 1, 0, 0, 0, 0, 1],
       [1, 0, 1, 1, 0, 1, 0, 1, 1, 1, 1, 1, 0, 1, 0, 1, 1, 0, 1],
       [1, 0, 0, 0, 0, 0, 0, 0, 0, 0, 0, 0, 0, 0, 0, 0, 0, 0, 1],
       [1, 0, 1, 1, 0, 1, 1, 1, 0, 1, 0, 1, 1, 1, 0, 1, 1, 0, 1],
       [1, 0, 0, 0, 0, 0, 0, 0, 0, 1, 0, 0, 0, 0, 0, 0, 0, 0, 1],
       [1, 1, 1, 1, 1, 1, 1, 1, 1, 1, 1, 1, 1, 1, 1, 1, 1, 1, 1]]

map2 = [[1,1,1,1,1,1,1,1,1,1,1,1,1,1,1,1,1,1,1,1,1,1,1,1,1,1,1,1],
        [1,2,2,2,2,2,2,2,2,2,2,2,2,1,1,2,2,2,2,2,2,2,2,2,2,2,2,1],
        [1,2,1,1,1,1,2,1,1,1,1,1,2,1,1,2,1,1,1,1,1,2,1,1,1,1,2,1],
        [1,3,1,0,0,1,2,1,0,0,0,1,2,1,1,2,1,0,0,0,1,2,1,0,0,1,3,1],
        [1,2,1,1,1,1,2,1,1,1,1,1,2,1,1,2,1,1,1,1,1,2,1,1,1,1,2,1],
        [1,2,2,2,2,2,2,2,2,2,2,2,2,2,2,2,2,2,2,2,2,2,2,2,2,2,2,1],
        [1,2,1,1,1,1,2,1,1,2,1,1,1,1,1,1,1,1,2,1,1,2,1,1,1,1,2,1],
        [1,2,1,1,1,1,2,1,1,2,1,1,1,1,1,1,1,1,2,1,1,2,1,1,1,1,2,1],
        [1,2,2,2,2,2,2,1,1,2,2,2,2,1,1,2,2,2,2,1,1,2,2,2,2,2,2,1],
        [1,1,1,1,1,1,2,1,1,1,1,1,0,1,1,0,1,1,1,1,1,2,1,1,1,1,1,1],
        [1,0,0,0,0,1,2,1,1,1,1,1,0,1,1,0,1,1,1,1,1,2,1,0,0,0,0,1],
        [1,0,0,0,0,1,2,1,1,0,0,0,0,0,0,0,0,0,0,1,1,2,1,0,0,0,0,1],
        [1,0,0,0,0,1,2,1,1,0,1,1,0,0,0,0,1,1,0,1,1,2,1,0,0,0,0,1],
        [1,1,1,1,1,1,2,1,1,0,1,0,0,0,0,0,0,1,0,1,1,2,1,1,1,1,1,1],
        [0,0,0,0,0,0,2,0,0,0,1,0,0,0,0,0,0,1,0,0,0,2,0,0,0,0,0,0],
        [1,1,1,1,1,1,2,1,1,0,1,0,0,0,0,0,0,1,0,1,1,2,1,1,1,1,1,1],
        [1,0,0,0,0,1,2,1,1,0,1,1,1,1,1,1,1,1,0,1,1,2,1,0,0,0,0,1],
        [1,0,0,0,0,1,2,1,1,0,0,0,0,0,0,0,0,0,0,1,1,2,1,0,0,0,0,1],
        [1,0,0,0,0,1,2,1,1,0,1,1,1,1,1,1,1,1,0,1,1,2,1,0,0,0,0,1],
        [1,1,1,1,1,1,2,1,1,0,1,1,1,1,1,1,1,1,0,1,1,2,1,1,1,1,1,1],
        [1,2,2,2,2,2,2,2,2,2,2,2,2,1,1,2,2,2,2,2,2,2,2,2,2,2,2,1],
        [1,2,1,1,1,1,2,1,1,1,1,1,2,1,1,2,1,1,1,1,1,2,1,1,1,1,2,1],
        [1,2,1,1,1,1,2,1,1,1,1,1,2,1,1,2,1,1,1,1,1,2,1,1,1,1,2,1],
        [1,3,2,2,1,1,2,2,2,2,2,2,2,0,0,2,2,2,2,2,2,2,1,1,2,2,3,1],
        [1,1,1,2,1,1,2,1,1,2,1,1,1,1,1,1,1,1,2,1,1,2,1,1,2,1,1,1],
        [1,1,1,2,1,1,2,1,1,2,1,1,1,1,1,1,1,1,2,1,1,2,1,1,2,1,1,1],
        [1,2,2,2,2,2,2,1,1,2,2,2,2,1,1,2,2,2,2,1,1,2,2,2,2,2,2,1],
        [1,2,1,1,1,1,1,1,1,1,1,1,2,1,1,2,1,1,1,1,1,1,1,1,1,1,2,1],
        [1,2,1,1,1,1,1,1,1,1,1,1,2,1,1,2,1,1,1,1,1,1,1,1,1,1,2,1],
        [1,2,2,2,2,2,2,2,2,2,2,2,2,2,2,2,2,2,2,2,2,2,2,2,2,2,2,1],
        [1,1,1,1,1,1,1,1,1,1,1,1,1,1,1,1,1,1,1,1,1,1,1,1,1,1,1,1]]


while True:
    detect_key_press() # chepa pk ca ecrit 15mille fois mais osef
